11111111111111111111111111111111111111111111111111111111111111111111111111111111111111111111111111111111111111111111111111111
100000000000000000000000000000000000000000#0000000000000000000000000000000000000000000000000000000000000000000000000000000001
10000000000000000000000000005000000000000000000000000000002222000002020207000000000020202020202000000000000000000000000000001
10000000000000000000000000011100000010000000000000050000011111100011111111000050000011111111111000000000000000000000000000001
10000000000000000000000000111110001111110000000011111110000000000000000000001111100000000000000000000000000000000000000000001
10000000000000000000000011111110111111000000100000000000000000000000000000000000000000000000000000000000000000000000000000001
10000000000000050000001111111111111111000011110000000000000000005000000000000000050000000000000000000001000000000000000000001
10000000011111111111111111111111111111111111111111111111111111111111111111111111111111111111111111111111100000000000000000001
10000000000111111111111111111111111111111111111111111111111111111111111111111111111111111111111111111111110000000000000000001
10000000000000000000000000000000000000000000000000000000000000000000000000000000000000000000000000001111111050000000000000001
10000000000000000000000000000000000000000000000022200000050000000000000000000000000000000000000000001111111111100000000000001
10000000011000000000000000001111111111111111110000000222222222222200000000000000000000000000000000001111100000000000000000001
10000000111102220050002220111111111111111111111000001111111111111110050000000000000000000000000000001111100000000000000000001
10000011111111111111111111111111111111111111111110111111111111111111111110000000000070000000000000001111100000000000000000001
10000000000111111111111111111111111111111111111110111111111111111111111111111111111111111111000000001111100000000000000050091
10000000000000111111111111111111111111111111111110111111111111111111111111111111111111111111000000001111100000000000111111111
10000000000000000000000000000000000000000000000000000000000000000000000000000000000000000000000002001111100050000000000000001
10000000000000000000000000000000000000000000000004000000000000000000000000000000000000000000000002001111111111100000000000001
10000000000000000000000000000000000050000000000000000000000000000000000000000000000000000000000002001111100000000000000000001
10000000000000000000000005000111111111111111111110000000000000000000000000000050000000000000000002001111100000000000000000001
10000000000000000000070111111111111100000000000010000000000000000000000000011111110000000000000002001111100000000000000000001
10000000001111111111111111111111111100000000000010000000000000000000500000000000000000000000000002001111100000000000000500001
10000000000000000000000000000000000000000000000000000000000000000011111100000000000000000000000000001111100000000000111111111
10000000000000000000000000000000000000000000000000000000000000050011111100000000050000000000000000501111100220000000000000001
10000000000000000000000000000000000000000000000000000000000001111111111105000000111000000000000001111111111111100000000000001
10000000000000000000000000000000000000000000000000000000005011111111111111100001111000000000000000000000000000000000000000001
10000000000000000111000000000000000000000000000000000000111111111111111111100001111110000010000000000000000000000000000000001
10000000000000001111100500000000000000000000000000500000111111111111111111110011111111050111000000000000000500000005000000001
10000000000001111111111111111111111111000000011111111111111111111111111111111111111111111111100001111111111111111111111111111
10000000000111111111111111111111111111000000011111111111111111111111111111111111111111111111100001111111111111111111111111111
10000000011111111111111111111111111111000000011111111111111111111111111111111111111111111111111111111111111111111111111111111
10000001111111111111111111111111111111100000011111111111111111111111111111111111111111111111111111111111111111111111111111111
10000111111111111111111111111111111111111110000111111111111111111111111111111111111111111111111111111111111111111111111111111
12011111111111111111111111111111111111111110000111111111111111111111111111111111111111111111111111111111111111111111111111111
11111111111111111111111111111111111111111110000000011111111111111111111111111111111111111111111111111100000000000000000000001
11111111111111111111111111111111111111111110050000011111111111111111111111111111111111110000000000000000000000000000000000003
11111111111111111111111111111111111111111111111110000000000000000000000000000000000000000000500000000000000000005000000006003
11111111111111111111111111111111111111111111111110000000000000000000000000000000000000001111111110000000000001111111111111111
11111111111111111111111111111111111111111111111110000000000000000000000000000000000000000000000000000000005001000000000000001
11111111111111111111111111111111111111111111111111100000500000000000000000000000000000000000000000000001111111000000000000001
11111111111111111111111111111111111111111111111111111111111111111111000000000000000000000000050000000000000000000000000000001
11111111111111111111111111111111111111111111111111111111111111111111000000000000202020000011111111000000000000000000000000001
11111111111111111111111111111111111111111111111111111111111111111111110000000001111111000000000000111111111111000000000000001
11111111111111111111111111111111111111111111111111111111111111111111010000000000000000000000000000000000000000100000000002221
11111111111111111111111111111111111111111111111111111111111111111111011000000000000500000000000000000000000000010050000002221
11111111111111111111111111111111111111111111111111111111111111111111111111111111111111111111111111111111111111111111111111111

