11111111111111111111111111111111111111111111111111111111111111111111111111111111111111111111111111111111111111111111111111111
100000000000000000000000000000000000000000#0000000000000000000000000000000000000000000000000000000000000000000000000000000001
10000000000000000000000000000000000000000000000000000000002222000002020207000000000020202020202000000000000000000000000000001
10000000000000000000000000011100000010000000000000050001111111101011111111000000010011111111111000000000000000000000000000001
1000000000000000000000000011111000111111000000001111111000000001000000000000111110010000000000000000000000000000^000000000001
1000000000000000000000001111111011111100000010000000000000000000000000000000000000000000000000000000000000000000^000000000001
1000000000000005000000111111111111111160001111000000000000000000500000000000000000000000000000000000000100000000^000000000001
1000000001111111111111111111111111111111111111111111111111111111111111111111111111111111111111111111111110000000^000000000001
1000000000011111111111111111111111111111111110000000001111111111111111111111111111111111111111111111111111000000^000000000001
1000000000000000000000000000000000000000000000000000000000000000000000000000000000000000000000000000111111100000^000000000001
1000000000000000000000000000000000000000000000002220000005000000000000000000000000000000000000000000111111111110^000000000001
1000000001100000000000000000111111111111111111000000022222222222220000000000000000000000000000000000111110000000^000000000001
1000000011110222022200222011111111111111111111100000111111111111111000000000000000000000000000000000111110000000^000000000001
1000001111111111111111111111111111111111111111111011111111111111111111111000000000007000000000000000111110000000^000000000001
1000000000011111111111111111111111111111111111111011111111111111111111111111111111111111111100000000111110000000^000000050091
1000000000000011111111111111111111111111111111111011111111111111111111111111111111111111111100000000111110000000^000111111111
1000000000000000000000000000000000000000000000000000000000000000000000000000000000000000000000000200111110000000^000000000001
1000000000000000000000000000000000000000000000000400000000000000000000000000000000000000000000000200111111111110^000000000001
1000000000000000000000000000000000005000000000000000000000000000000000000000000000000000000000000200111110000000^000000000001
1000000000000000000000000500011111111111111111111000000000000000000000000000005000000000000000000200111110000000^000000000001
1000000000000000000007011111111111110000000000001000000000000000000000000001111111000000000000000200111110000000^000000000001
1000000000111111111111111111111111110000000000001000000000000000000000000000000000000000000000000200111110000000^000000000001
1000000000000000000000000000000000000000000000000000000000000000001111110000000000000000000000000000111110000000^000111111111
1000000000000000000000000000000000000000000000000000000000000005001111110000000005000000000000000050111110022000^000000000001
1000000000000000000000000000000000000000000000000000000000000111111111110000000011100000000000000111111111111110^000000000001
1000000000000000000000000000000000000000000000000000000000501111111111111110000111100000000001100000000000000000^000000000001
1000000000000000011100000000000000000000000000000000000011111111111111111110000111111000001000000000000000000000^000000000001
1000000000000000111110050000000000000000000000000000000011111111111111111111001111111100011100000000000000000000^000000000001
10000000000001111111111111111111111111010101011111111111111111111111111111111111111111111111100001111111111111111111111111111
10000000000111111111111111111111111111000000011111111111111111111111111111111111111111111111122221111111111111111111111111111
10000000011111111111111111111111111111000000011111111111111111111111111111111111111111111111111111111111111111111111111111111
10000001111111111111111111111111111111100000011111111111111111111111111111111111111111111111111111111111111111111111111111111
10000111111111111111111111111111111111111110000111111111111111111111111111111111111111111111111111111111111111111111111111111
1$011111111111111111111111111111111111111110000111111111111111111111111111111111111111111111111111111111111111111111111111111
11111111111111111111111111111111111111111110000000011111111111111111111111111111111111111111111111111100000000000000000000001
11111111111111111111111111111111111111111111000000011111111111111111111111111111111111110000000000000000000000000000000000003
11111111111111111111111111111111111111111111111110000000000000000000000000000000000000000000000000000000000000005000000000003
11111111111111111111111111111111111111111111111110000000000000000000000000000000000000000011111110000000000001111111111111111
11111111111111111111111111111111111111111111111110000000000000000000000000000000000000000000000001110000222201000000000000001
11111111111111111111111111111111111111111111111111100000500000000000000000000000000000000000000000000001111111000000000000001
11111111111111111111111111111111111111111111111111111111111111111111000000000000000000000000070000000100000000000000000000001
1111111111111111111111111111111111111111111111111111111111111111111100000000000020202001101111111100000002222&000000000000001
11111111111111111111111111111111111111111111111111111111111111111111110000000001111111000000000000111111111111000000000000001
11111111111111111111111111111111111111111111111111111111111111111111010000000000000000000000000000000000000000100002222222221
11111111111111111111111111111111111111111111111111111111111111111111011000000000000000000000000000000000000000010052222222221
11111111111111111111111111111111111111111111111111111111111111111111111111111111111111111111111111111111111111111111111111111

